{
  "name": "Sofle",
  "vendorProductId": 4231135879,
  "macros": ["", "", "", "", "", "", "", "", "", "", "", "", "", "", "", ""],
  "layers": [
    [
      "KC_ESC",
      "KC_1",
      "KC_2",
      "KC_3",
      "KC_4",
      "KC_5",
      "KC_TAB",
      "KC_Q",
      "KC_W",
      "KC_E",
      "KC_R",
      "KC_T",
      "KC_LCTL",
      "KC_A",
      "KC_S",
      "KC_D",
      "KC_F",
      "KC_G",
      "KC_LSFT",
      "KC_Z",
      "KC_X",
      "KC_C",
      "KC_V",
      "KC_B",
      "KC_BSLS",
      "KC_END",
      "KC_HOME",
      "KC_LGUI",
      "KC_ENT",
      "KC_MUTE",
      "KC_BSPC",
      "KC_0",
      "KC_9",
      "KC_8",
      "KC_7",
      "KC_6",
      "KC_LBRC",
      "KC_P",
      "KC_O",
      "KC_I",
      "KC_U",
      "KC_Y",
      "KC_QUOT",
      "KC_SCLN",
      "KC_L",
      "KC_K",
      "KC_J",
      "KC_H",
      "KC_RSFT",
      "KC_SLSH",
      "KC_DOT",
      "KC_COMM",
      "KC_M",
      "KC_N",
      "KC_INS",
      "KC_RALT",
      "MO(2)",
      "MO(1)",
      "KC_SPC",
      "KC_MPLY"
    ],
    [
      "KC_ESC",
      "KC_F1",
      "KC_F2",
      "KC_F3",
      "KC_F4",
      "KC_F5",
      "KC_TAB",
      "KC_F11",
      "KC_F12",
      "KC_TRNS",
      "KC_TRNS",
      "KC_TRNS",
      "KC_CAPS",
      "KC_A",
      "KC_S",
      "KC_TRNS",
      "KC_F",
      "KC_TRNS",
      "KC_LSFT",
      "KC_Z",
      "KC_X",
      "KC_C",
      "KC_TRNS",
      "KC_TRNS",
      "KC_LGUI",
      "KC_PGDN",
      "KC_PGUP",
      "KC_LGUI",
      "KC_ENT",
      "KC_MUTE",
      "KC_DEL",
      "KC_F10",
      "KC_F9",
      "KC_F8",
      "KC_F7",
      "KC_F6",
      "KC_RBRC",
      "KC_EQL",
      "KC_MINS",
      "KC_UP",
      "KC_TRNS",
      "KC_Y",
      "KC_TRNS",
      "KC_SCLN",
      "KC_RGHT",
      "KC_DOWN",
      "KC_LEFT",
      "KC_TRNS",
      "KC_GRV",
      "KC_TRNS",
      "KC_TRNS",
      "KC_TRNS",
      "KC_TRNS",
      "KC_TRNS",
      "KC_RCTL",
      "KC_RALT",
      "MO(3)",
      "KC_TRNS",
      "KC_SPC",
      "KC_MPLY"
    ],
    [
      "KC_F13",
      "KC_F14",
      "KC_F15",
      "KC_F16",
      "KC_F17",
      "KC_F18",
      "KC_TAB",
      "KC_TRNS",
      "KC_TRNS",
      "KC_TRNS",
      "KC_TRNS",
      "KC_TRNS",
      "KC_TRNS",
      "KC_TRNS",
      "KC_TRNS",
      "KC_TRNS",
      "KC_TRNS",
      "KC_TRNS",
      "KC_TRNS",
      "KC_TRNS",
      "KC_TRNS",
      "KC_TRNS",
      "KC_TRNS",
      "KC_TRNS",
      "KC_NLCK",
      "KC_TRNS",
      "KC_TRNS",
      "KC_SPC",
      "KC_PENT",
      "KC_MUTE",
      "KC_F24",
      "KC_F23",
      "KC_F22",
      "KC_F21",
      "KC_F20",
      "KC_F19",
      "KC_TRNS",
      "KC_TRNS",
      "KC_P9",
      "KC_P8",
      "KC_P7",
      "KC_TRNS",
      "KC_TRNS",
      "S(KC_EQL)",
      "KC_P6",
      "KC_P5",
      "KC_P4",
      "KC_TRNS",
      "KC_TRNS",
      "KC_EQL",
      "KC_P3",
      "KC_P2",
      "KC_P1",
      "KC_P0",
      "KC_RCTL",
      "KC_RALT",
      "KC_TRNS",
      "KC_TRNS",
      "KC_SPC",
      "KC_MPLY"
    ],
    [
      "KC_TRNS",
      "KC_TRNS",
      "KC_TRNS",
      "KC_TRNS",
      "KC_TRNS",
      "KC_TRNS",
      "RGB_MOD",
      "KC_TRNS",
      "KC_TRNS",
      "KC_TRNS",
      "KC_TRNS",
      "KC_TRNS",
      "RGB_RMOD",
      "KC_TRNS",
      "KC_TRNS",
      "KC_TRNS",
      "KC_TRNS",
      "KC_TRNS",
      "KC_TRNS",
      "KC_TRNS",
      "KC_TRNS",
      "KC_TRNS",
      "KC_TRNS",
      "KC_TRNS",
      "KC_TRNS",
      "KC_TRNS",
      "KC_TRNS",
      "BL_TOGG",
      "RGB_TOG",
      "KC_MUTE",
      "KC_TRNS",
      "KC_TRNS",
      "KC_TRNS",
      "KC_TRNS",
      "KC_TRNS",
      "KC_TRNS",
      "KC_TRNS",
      "KC_TRNS",
      "KC_TRNS",
      "KC_TRNS",
      "KC_TRNS",
      "KC_TRNS",
      "KC_TRNS",
      "KC_TRNS",
      "KC_TRNS",
      "KC_TRNS",
      "KC_TRNS",
      "KC_TRNS",
      "KC_TRNS",
      "KC_TRNS",
      "KC_TRNS",
      "KC_TRNS",
      "KC_TRNS",
      "KC_TRNS",
      "KC_TRNS",
      "KC_TRNS",
      "KC_TRNS",
      "KC_TRNS",
      "KC_TRNS",
      "KC_MPLY"
    ],
    [
      "KC_TRNS",
      "KC_TRNS",
      "KC_TRNS",
      "KC_TRNS",
      "KC_TRNS",
      "KC_TRNS",
      "KC_TRNS",
      "KC_TRNS",
      "KC_TRNS",
      "KC_TRNS",
      "KC_TRNS",
      "KC_TRNS",
      "KC_TRNS",
      "KC_TRNS",
      "KC_TRNS",
      "KC_TRNS",
      "KC_TRNS",
      "KC_TRNS",
      "KC_TRNS",
      "KC_TRNS",
      "KC_TRNS",
      "KC_TRNS",
      "KC_TRNS",
      "KC_TRNS",
      "KC_TRNS",
      "KC_TRNS",
      "KC_TRNS",
      "KC_TRNS",
      "KC_TRNS",
      "KC_TRNS",
      "KC_TRNS",
      "KC_TRNS",
      "KC_TRNS",
      "KC_TRNS",
      "KC_TRNS",
      "KC_TRNS",
      "KC_TRNS",
      "KC_TRNS",
      "KC_TRNS",
      "KC_TRNS",
      "KC_TRNS",
      "KC_TRNS",
      "KC_TRNS",
      "KC_TRNS",
      "KC_TRNS",
      "KC_TRNS",
      "KC_TRNS",
      "KC_TRNS",
      "KC_TRNS",
      "KC_TRNS",
      "KC_TRNS",
      "KC_TRNS",
      "KC_TRNS",
      "KC_TRNS",
      "KC_TRNS",
      "KC_TRNS",
      "KC_TRNS",
      "KC_TRNS",
      "KC_TRNS",
      "KC_TRNS"
    ]
  ],
  "encoders": [
    [
      ["KC_LEFT", "KC_RGHT"],
      ["KC_VOLU", "KC_VOLD"],
      ["KC_MS_WH_UP", "KC_MS_WH_DOWN"],
      ["RGB_VAI", "RGB_VAD"],
      ["KC_TRNS", "KC_TRNS"]
    ],
    [
      ["KC_UP", "KC_DOWN"],
      ["KC_VOLU", "KC_VOLD"],
      ["KC_VOLU", "KC_VOLD"],
      ["KC_VOLU", "KC_VOLD"],
      ["KC_TRNS", "KC_TRNS"]
    ]
  ]
}